"a" = (/turf/grass/grassHigh,/area)
"b" = (/turf/grass/grassMed,/area)
"c" = (/turf/grass/grassLow,/area)
"d" = (/turf/housewall,/area)
"e" = (/elevation/groundfloor,/elevation/secondfloor,/elevation/thirdfloor,/turf/grass/grassLow,/area)
"f" = (/elevation/groundfloor,/obj/item/box,/elevation/secondfloor,/obj/item/box{elevel = 2},/elevation/thirdfloor,/turf/grass/grassLow,/area)
"g" = (/elevation/groundfloor,/elevation/secondfloor,/elevation/thirdfloor,/obj/clock{elevel = 3},/turf/grass/grassLow,/area)
"h" = (/elevation/groundfloor,/obj/clock,/elevation/thirdfloor,/turf/grass/grassLow,/area)
"i" = (/elevation/groundfloor,/elevation/thirdfloor,/turf/grass/grassLow,/area)
"j" = (/elevation/groundfloor,/elevation/secondfloor,/obj/clock{elevel = 2},/elevation/thirdfloor,/turf/grass/grassLow,/area)
"k" = (/elevation/platformHigh,/turf/wall,/area)
"l" = (/turf/wall,/area)
"m" = (/obj/item/circle,/turf/grass/grassMed,/area)
"n" = (/obj/item/circle,/turf/grass/grassLow,/area)
"o" = (/elevation/platformHighest{elevel = 3},/turf/housewall,/area)
"p" = (/elevation/platformHighest,/turf/grass/grassMed,/area)
"q" = (/elevation/groundfloor,/elevation/secondfloor,/obj/item/circle{elevel = 2},/elevation/thirdfloor,/obj/item/square{elevel = 3},/turf/grass/grassLow,/area)
"r" = (/obj/item/circle,/obj/item/circle,/turf/grass/grassLow,/area)
"s" = (/elevation/groundfloor,/elevation/stairs/Nstairs{elevel = 1.5},/elevation/thirdfloor,/turf/grass/grassLow,/area)
"t" = (/elevation/groundfloor,/elevation/secondfloor,/elevation/stairs/Nstairs{elevel = 2.5},/turf/grass/grassLow,/area)
"u" = (/turf/grass/grassHest,/area)
"v" = (/elevation/groundfloor,/elevation/platformHigh,/elevation/thirdfloor,/turf/grass/grassLow,/area)
"w" = (/elevation/groundfloor,/obj/item/box,/elevation/secondfloor,/elevation/thirdfloor,/turf/grass/grassLow,/area)
"x" = (/elevation/platformMedium,/turf/wall,/area)
"y" = (/elevation/groundfloor,/elevation/secondfloor,/turf/grass/grassLow,/area)
"z" = (/elevation/groundfloor,/obj/item/box,/elevation/secondfloor,/elevation/stairs/Nstairs{elevel = 2.5},/turf/grass/grassLow,/area)
"A" = (/elevation/groundfloor,/elevation/secondfloor,/obj/item/box{elevel = 2},/elevation/thirdfloor,/turf/grass/grassLow,/area)
"B" = (/elevation/platformHigh,/turf/water,/area)
"C" = (/turf/water,/area)
"D" = (/elevation/platformMedium,/turf/water,/area)
"E" = (/elevation/groundfloor,/turf/grass/grassLow,/area)
"F" = (/elevation/groundfloor,/obj/item/circle,/elevation/secondfloor,/elevation/thirdfloor,/turf/grass/grassLow,/area)
"G" = (/elevation/groundfloor,/elevation/secondfloor,/elevation/thirdfloor,/obj/item/square{elevel = 3},/turf/grass/grassLow,/area)
"H" = (/elevation/groundfloor,/elevation/thirdfloor,/obj/item/square{elevel = 3},/turf/grass/grassLow,/area)
"I" = (/elevation/platformHigh,/turf/grass/grassMed,/area)
"J" = (/obj/item/square,/turf/grass/grassLow,/area)
"K" = (/elevation/platformLow,/turf/wall,/area)
"L" = (/elevation/platformLow,/turf/water,/area)
"M" = (/obj/item/square,/turf/grass/grassHigh,/area)
"N" = (/obj/item/circle,/turf/grass/grassHigh,/area)
"O" = (/elevation/platformHigh,/turf/grass/grassLow,/area)
"P" = (/obj/item/square,/turf/grass/grassHest,/area)
"Q" = (/obj/item/circle,/turf/grass/grassHest,/area)
"R" = (/elevation/platformHighest,/turf/grass/grassLow,/area)
"S" = (/obj/item/square,/turf/grass/grassMed,/area)
"T" = (/turf,/area)

(1,1,1) = {"
aaaabbbbbcddddddddddbbbbbbbddddddddddddd
aaabbbbbbcdeeeeeeeedbbbbbbbdfgeeehiieejd
klbmmbcnccdeeeeeeeeopppppppoeeeeeiiiqeed
klbbccrcnndsieeeeetdbbuuubbdeeeeevvvweed
klxllllllcdiieeeeeydbaaauubdzeesAiiieetd
BCxlCCCCCcdiieeeeeedaaaaaaadyeeiiiiieeyd
BCDCCCCCCndEddddddddbbbbbbbdeFGiiiiHeAed
IbbcccCCCncccccccccbbbbbbbbdddEddddddddd
aabbccCCCccccJlllccbbaabccccccccccccbbbb
aabbccCCCllKllCCCccbllklcccccccccccccbbb
bbbbbccCCCCLCCCCClllllklllllccccccccccbb
baaabbccccccccCCCCCCClkCCCCCcccccbllllbb
aaaaMabbbbbbbccCCCCCCCBCCCCCcccbbbCCCCbb
auuuubbbaaaaNbccccccccOccCCClKlbbbDDDDbb
auuuupppuuuuabbcccuuaaaccCCCCLClllCCCCll
auPllbbbuQuuuppRRRuuaauccCCCCLCCCCCCCCll
allbbbbblluulbbbccuuuulccccccccccccccCCC
bbbbbSbbbbllbbbbcclllllcccccccaacccccCCC
bbbbbbbbbbbbbbbbbcllllcccbbbbaaabbcccccc
bbbbcccccbbbbbbbbbbbbbbbbbbbaaaabbcccccc
"}

(1,1,2) = {"
aaaabbbbbcddddddddddTTTTTTTTTTTTTTTTTTTT
aaabbbbbbcdeeeeeeeedTTTTTTTTTTTTTTTTTTTT
klbmmbcnccdeeeeeeeedTTTTTTTTTTTTTTTTTTTT
klbbccrcnndsieeeeetdTTTTTTTTTTTTTTTTTTTT
BCxllllllcdiieeeeeydTTTTTTTTTTTTTTTTTTTT
BCDCCCCCCcdiieeeeeedTTTTTTTTTTTTTTTTTTTT
BCDCCCCCCndEddddddddTTTTTTTTTTTTTTTTTTTT
IbbcccCCCnccccccccccTTTTTTTTTTTTTTTTTTTT
aabbccCCCccJcclllcccTTTTTTTTTTTTTTTTTTTT
aabbccCCCllKllCCCcccTTTTTTTTTTTTTTTTTTTT
bbbbbccCCCCLCCCCClllTTTTTTTTTTTTTTTTTTTT
baaabbccccccccCCCCCCTTTTTTTTTTTTTTTTTTTT
aaaaMabbbbbbbccCCCCCTTTTTTTTTTTTTTTTTTTT
auuuubbbaaaaNbccccccTTTTTTTTTTTTTTTTTTTT
auuuupppuuuuabbcccuuTTTTTTTTTTTTTTTTTTTT
auullbbbuQuuuppRRRuuTTTTTTTTTTTTTTTTTTTT
allbbbbblluulbbbccllTTTTTTTTTTTTTTTTTTTT
bbbbbSbbbbllbbbbccllTTTTTTTTTTTTTTTTTTTT
bbbbbbbbbbbbbbbbbcccTTTTTTTTTTTTTTTTTTTT
bbbbcccccbbbbbbbbcccTTTTTTTTTTTTTTTTTTTT
"}
