"a" = (/turf,/area)
"b" = (/turf/bird,/area)

(1,1,1) = {"
aabaaaaaa
aaaaaaaaa
aaaaaaaaa
aaaaaabaa
aaaaaaaaa
aaaaaaaaa
baaaaaaaa
aaaaaaaaa
aaaaaaaba
"}
