"a" = (/turf/wall,/area)
"b" = (/turf,/area)
"c" = (/mob/shooter,/turf,/area)

(1,1,1) = {"
aaaaaaaaaaaaaaaaaaaaaaaaaaaaaaaaaaaaaaa
aaabbbbbbbbbbbbbbbbbbbbbbbbbbbbbbbbbbba
aabbbbbbbbbcbbbbbbbbbbbbbbbbbbbbbbbbbba
abbbbbbbbbbbbbbbbbbbbbbbbcbbbbbbbbbbbba
abbbbaaaabbbbabbbbbbbbbbbbbbbbbbbbbbbba
abbbbaaabbbbaabbbbbbbabbbbbbbbaaaaabbba
abbbbaabbbbaaabbbbbbbabbbbbbbbabbbbbbba
abbbbabbbbaaaabbbbbbbabbbbbbbbabbbbbbba
abbbbbbbbbbbbbbbbbbbbabbbbbbbbabbbbbbba
abbbbbbbbbbbbbbbbbbbbabbbbbbbbabbbbbbba
aaabbbbbaaaaaabbaaabbabbbbbbbbabbbbbbba
abbbbbbbbbbbbbbbbbabbaaaaaaaaaabbbaaaaa
abbbbcbbbbbbbbbbbbabbbbbbbbbbbabbbbbbba
abbbbbbbaaaaaaaaababbbbbbbbbbbabbbbbbba
abbbbbbbbbbbbbbbababbaaaaaaabbbbbbbbbba
aaabbbbbabbbbbbbababbabbbbbabbbbbbbbbba
abbbbbbbaabbbbbbbbabbabbbbbabbaaaaaaaaa
abbbbbbbaaabbaabbbabbbbbbbbbbbbbbbbbbba
abbbbbbbbbbbbbaabbabbbbbbbbbbbbbbbbbbba
abbbbbbbbbbbbbbbbaabbabbbbbabbbbbbbabba
abbbbaaaaabbaaaaaaabbaabbbaabbbbbbbaaaa
abbbaabbbbbbabbbbbbbbbbbcbbbbbbbbbbbbba
abbaabbbbabbabbbbbabbbbbbbbbbbcbbbbbbba
aabbbbbbbbbbbbbbbbabbaabbbbbbbbbbaaabba
aaabbbbbbabbaabbbbabbaabbbbbbbbbbbaabba
abbbbbbbbbbbaaabbbbbbbbbbbbbbbabbbbabba
abbbbbbbbbbbaaaabbabbbbbbbbbbaaabbbbbba
abbbbbbbbabbbbbbbaabbbbbbbbbaaaaabbbbaa
aaaaaaaaaaaaaaaaaaaaaaaaaaaaaaaaaaaaaaa
"}
