"a" = (/mob/eyeglow_mob,/turf,/area)
"b" = (/obj/fire,/turf,/area)
"c" = (/turf,/area)
"d" = (/obj/tree,/turf,/area)
"e" = (/mob,/turf,/area)

(1,1,1) = {"
cccccccccccccccccccccccccccccccccccccccc
cccccccccccccccccccccccccccccccccccccccc
cccccccccccccccccccccccccccccccccccccccc
ccccacccccccaccccccccccccacccccccccccccc
cccccccccccccccecccccccccccccccccccccccc
cccccccccccccccccccccccbcccccccccccccccc
ccccccccccccccccccccccccccbccccccccccccc
cccccccbcccdcccccdcccccccccccccdcccccccc
ccccccccccccccbccccccccccccccccccccccccc
ccccccccccccccccccccbcdccccceccbcccccccc
ccccccccccccccdccccbbbcccccccccacccccccc
cccccccdccccccccccbcbbcccccccccccccccccc
cccceccccccbccccbbcccbccccdccccccccccccc
ccccccccccecccccbcbcaccccdcccccccccccccc
cccccdcccccbccccdccccccccccccccccccccccc
ccccccccccccccccbcccccccccccdccdcccccccc
cccccccdccccccccccbccccacccbccbccccccccc
ccccdccccccccccccccccccccbbccccccccccccc
ccccccccdccccbcccdcccccecbcccccccccccccc
ccccccbccccccccccccccbccccdccccccccacccc
ccccccccacccccccccccccccbcbcbccccccccccc
ccccccccccccccccccccccccdccccccccccccccc
ccccccccbccaccccdccccccccccbccdccccccccc
ccccccccccccdccccccccbcbcccccccccccccccc
cccccdccccccccbccccccccdcccccccccccccccc
ccccccccccccbcccccccccccdccccccccccccccc
cccccccccccccccccccdccccccdccccccccccccc
cccccccccccccccccccccccccccccccccccccccc
cccccccccccccccccccccccccccccccccccccccc
cccccccccccccccccccccccccccccccccccccccc
"}
