"a" = (/turf/wall,/area)
"b" = (/turf,/area)

(1,1,1) = {"
aaaaaaaaaaaaaaaaaaa
abbbbbbbbbbbbbbbbba
abbbbbbbbbbbbbbbbba
abbbbbbbaaaaaaaaaba
abbbbbbbbbbbbbbbaba
aaaaabbaabbbbbbbaba
abbbbbbbaabbbbbbbba
abbbbbbbaaabbaabbba
abbbbbbbbbbbbbaabba
abbbbbbbbbbbbbbbbaa
abbbbaaaaabbaaaaaaa
abbbaabbbbbbabbbbba
abbaabbbbabbbbbbbba
aabbbbbbbbbbbbbbbba
aaabbbbbbabbaabbbba
abbbbbbbbbbbaaabbba
abbbbbbbbbbbaaaabba
abbbbbbbbabbbbbbbaa
aaaaaaaaaaaaaaaaaaa
"}
