"a" = (/turf/forest/tree_paradise1,/area)
"b" = (/turf/forest/tree4,/area)
"c" = (/turf/forest/grass3,/area)
"d" = (/turf/forest/sign,/area)

(1,1,1) = {"
ababababab
bacacacaca
acccccccab
baccccccca
acccdcccab
baccccccca
acccccccab
bacacccaca
acacccacab
babaccbaba
"}
