"a" = (/turf,/area)
"b" = (/turf/grass,/area)
"c" = (/turf/sidewalk,/area)
"d" = (/turf/pavement,/area)
"e" = (/turf/brick,/area)
"f" = (/turf/floor,/area)
"g" = (/obj/lamp,/turf/floor,/area)

(1,1,1) = {"
aaaaaaaaaaaaaaaaaaaaaaaaaaaaaaaaaaaaaaaaa
abbbbbbbbbbbbbbbbbbbbbbbbcdddceeeeeeeeeea
abbbbbbbbbbbbbbbbbbbbbbbbcdddcebbbbbbbbea
abbbbbbbbbbbbbbbbbbbbbbbbcdddcebbbbbbbbea
abbbbbbbbbbbbbbbbbbbbbbbbcdddcbbbbbbbbbea
abbbbbbbbbbbbbbbbbbbbbbbbcdddcbbbbbbbbbea
aeeeeeffeeeeeebbbbbbbbbbbcdddcebbbbbbbbea
aefffffffffffebbbbbbbbbbbcdddcebbbbbbbbea
aefffffffffffebbbbbbbbbbbcdddcebbbbbbbbea
aeffffffffeffeebbbbbbbbbbcdddcebbbbbbbbea
aeffffffffeffffbbbbbbbbbbcdddcebbeefeeeea
aefgffffffeffffbbbbbeeeeecdddcebbefffffea
aeeeeffeeeeffeebbbbbeeeeecdddcebbefffffea
aaaeffffffeffebbbbbbeeeeecdddcebbefffffea
aaaeffffffeffebbbbbbeeeeecdddceeeeeefeeea
aaaegfffffecccccccccccccccdddcccceffffeaa
aaaeffffffecdddddddddddddddddccccfffffeaa
aaaeffffffecdddddddddddddddddccccffgffeaa
aaaeeefeeeecdddddddddddddddddccccfffffeaa
aaaaeffffebcdddcccccccccccccccccceffffeaa
aaaaeffffebcdddceeeeeeeeeeeeeeeeeeffffeaa
aaaaegfffebcdddcefffffffffffffffffffffeaa
aaaaeffffebcdddcefffffffffffffffffffffeaa
aaaaeffffebcdddcffffffffffffffffffffffeaa
aaaaeffffeecdddcffgfeeeeeeeeeeeeeeeeeeeaa
aaaaeffffffcdddcefffeaaaaaaaaaaaaaaaaaaaa
aaaaegfffffcdddcefffeaaaaaaaaaaaaaaaaaaaa
aaaaeeeeeeecdddceeeeeaaaaaaaaaaaaaaaaaaaa
aaaaaaaaaaaaaaaaaaaaaaaaaaaaaaaaaaaaaaaaa
"}
