"a" = (/turf,/area)
"b" = (/turf/wall,/area)

(1,1,1) = {"
aaaaaaaaaaaaaa
aaaaaaaaaaaaaa
aaaaaaaaaaaaaa
aaaaaaaaaaaaaa
baaaaaaaaaaaaa
baaaaaaaaaaaaa
baaaaaaaabaaaa
bbbaabbaabaaaa
baaaaaaabbaaaa
baaaaabbbbaaab
baaabaaaaaaaab
baabbaaaaaaaab
bbaaaaaaaaaaab
bbbbbbbbbbbbbb
"}
