"a" = (/turf/wall,/area)
"b" = (/turf,/area)

(1,1,1) = {"
aaaaaaaaaaaaaaaaaaaa
abbbabbabbbbbbbbbbba
abbbabbabbbbbbbbbbba
abbbbbbbbbbbbbbbbbba
abbbbbbbbbbbbbbbbbba
abbbabbabbabbabbbbba
abbbaaaabbabbabbbbba
abbbbbbbbbabbabbbbba
abbbbbbbbbabbaabbbba
abbbabbabbabbbbbbbba
abbbaaaabbabbbbbbbba
abbbbbbbbbabbaabbbaa
abbbbbbbbbabbabbbbba
abbbbbbbbbabbabbbbba
abbbbbaaaaabbabbbbba
abbbbbabbbbbbbbbbbba
abbbbbbbbbbbbbbbbbba
abbbbbbbbbbbbbbbbbba
abbbbbabbbbbbabbbbba
aaaaaaaaaaaaaaaaaaaa
"}
