"a" = (/turf,/area)
"b" = (/turf/wall,/area)
"c" = (/turf/floor,/area)
"d" = (/region/wire,/turf/door,/area)
"e" = (/region/wire,/turf/floor,/area)
"f" = (/region/wire,/turf/button,/area)

(1,1,1) = {"
abbbbbabbbbbbbbbbbb
abcccbbbccccccccccb
abccccccccccccccccb
abccccccccccccccccb
abcccbbbccccccccccb
abcccbabbdbdbdbbccb
abcccbabcecececcccb
bbbdbbbbcecfceccccb
bccecccbceccceccccb
bccecccbceefceccccb
bccfccccccccceccccb
bccccccccccfeeccccb
bccccccbccccccccccb
bbbbbbbbbbbbbbbbbbb
"}
